######################
#   #    #  #        #
#   #    #  #      ###
#     #     #   #    #
#######     #####    #
#     #  #  #        #
####  ####  #     ####
#     #  #  ###   #  #
#     #           #  #
#  #     ####        #
# ###    #  #  # ### #
#   #    #     #   # #
#  #######     #   # #
#     #  #     #   ###
#        #  ######   #
#  #     #       #   #
# ####   #       ##  #
# #  #   ###   ###   #
# #  #     #   #     #
#    ####     ##    ##
#    #         #     #
######################